1 1 1 1 124 101 77 117 107 93 85 94 109 102
2 1 1 1 13 28 24 16 22 27 26 20 15 21
3 1 1 1 74 67 101 72 70 78 88 92 82 80
4 1 1 1 44 67 74 50 59 70 72 64 54 61
5 1 1 1 106 125 162 112 120 139 151 149 129 136
6 1 1 1 24 47 44 31 39 46 45 37 30 38
7 1 1 1 101 67 77 88 78 71 73 85 93 81
8 1 1 1 56 47 28 52 49 40 34 36 43 42
9 1 1 1 162 125 165 151 139 140 152 168 169 153
10 1 1 1 28 47 24 34 40 39 31 26 27 32
11 1 1 1 165 137 161 158 147 148 159 166 167 157
12 1 1 1 77 47 56 66 55 49 52 62 69 58
13 1 1 1 101 125 74 110 118 108 91 82 92 99
14 1 1 1 161 137 124 159 148 134 130 138 150 145
15 1 1 1 47 67 44 53 60 59 50 45 46 51
16 1 1 1 74 125 106 91 108 120 112 96 87 103
17 1 1 1 101 137 125 113 126 135 132 118 110 123
18 1 1 1 124 137 101 130 134 126 113 107 117 122
19 1 1 1 125 137 165 132 135 147 158 152 140 146
20 1 1 1 77 67 47 73 71 60 53 55 66 63
21 1 1 1 56 97 77 68 83 90 84 69 62 76
22 1 1 1 86 97 56 89 95 83 68 65 75 79
23 1 1 1 77 97 124 84 90 105 116 109 94 98
24 1 1 1 13 19 28 14 17 23 25 22 16 18
25 1 1 1 161 133 160 155 143 144 154 163 164 156
26 1 1 1 97 133 124 111 121 128 127 116 105 119
27 1 1 1 124 133 161 127 128 143 155 150 138 141
28 1 1 1 1 19 13 8 12 17 14 10 5 11
29 1 1 1 160 133 86 154 144 115 100 114 142 131
30 1 1 1 19 86 56 35 57 75 65 41 29 48
31 1 1 1 19 56 28 29 41 43 36 25 23 33
32 1 1 1 86 133 97 100 115 121 111 95 89 104
33 1 1 1 1 13 2 5 10 9 6 3 4 7
